1                                                   2
1                                                   2
1                                                   2
1                                                   2
1                                                   2
1                                                   2
1                                                   2
1                                                   2
1                        l--r                       2
1                       46gg65                      2
1                                                   2
1                                                   2
1                                                   2
1                                                   2
1                                                   2
1                                                   2
1            4---5                                  2
1                                                   2
1                                                   2
14-------------------------------------------------52