1                                                   2
1                                                   2
1                                                   2
1                                                   2
1                                                   2
1                                                   2
1                                                   2
1                                                   2
1                        l--r                       2
1                       466665                      2
1                                                   2
1                                                   2
1                                                   2
1                                                   2
1                                                   2
1                                                   2
1            47775                                  2
1                                                   2
1                                                   2
1l-------------------------------------------------r2